0,0,0,0,0,0,0,0,0,0,0,0,0,0,0,0,0,0,0,0,0,0,0,0,0,0,0,0,0,0,0,
0,0,0,0,0,0,0,0,0,0,0,0,0,0,0,0,0,0,0,0,0,0,0,0,0,0,0,0,0,0,0,
0,0,0,0,0,0,0,0,0,0,0,0,0,0,0,0,0,0,0,0,0,0,0,0,0,0,0,0,0,0,0,
0,0,0,0,0,0,0,0,0,0,0,0,0,0,0,0,0,0,0,0,0,0,0,0,0,0,0,0,0,0,0,
0,0,0,0,0,0,0,0,0,0,0,0,0,0,0,0,0,0,0,0,0,0,0,0,0,0,0,0,0,0,0,
0,0,0,0,0,0,0,0,0,0,0,0,0,0,0,0,0,0,0,0,0,0,0,0,0,0,0,0,0,0,0,
0,0,0,0,0,0,12,12,12,12,12,12,12,12,12,12,12,12,12,12,12,12,12,12,0,0,0,0,0,0,0,
0,0,0,0,0,0,12,4,4,4,4,4,4,4,4,4,4,4,4,4,4,4,4,12,0,0,0,0,0,0,0,
0,0,0,0,0,0,12,4,4,4,4,4,4,4,4,4,4,4,4,4,4,4,4,12,0,0,0,0,0,0,0,
0,0,0,0,0,0,12,4,4,4,4,4,4,4,4,4,4,4,4,4,4,4,4,12,0,0,0,0,0,0,0,
0,0,0,0,0,0,12,4,4,4,4,4,4,4,4,4,4,4,4,4,4,4,4,12,0,0,0,0,0,0,0,
0,0,0,0,0,0,12,4,4,4,4,4,4,4,4,4,4,4,4,4,4,4,4,12,0,0,0,0,0,0,0,
0,0,0,0,0,0,12,4,4,4,4,4,4,4,4,4,4,4,4,4,4,4,4,12,0,0,0,0,0,0,0,
0,0,0,0,0,0,12,4,4,4,4,4,4,4,4,4,4,4,4,4,4,4,4,12,0,0,0,0,0,0,0, 
0,0,0,0,0,0,12,4,4,4,4,4,4,4,4,4,4,4,4,4,4,4,4,12,0,0,0,0,0,0,0,
0,0,0,0,0,0,12,4,4,4,4,4,4,4,4,4,4,4,4,4,4,4,4,12,0,0,0,0,0,0,0,
0,0,0,0,0,0,12,4,4,4,4,4,4,4,4,4,4,4,4,4,4,4,4,12,0,0,0,0,0,0,0,
0,0,0,0,0,0,12,4,4,4,4,4,4,4,4,4,4,4,4,4,4,4,4,12,0,0,0,0,0,0,0,
0,0,0,0,0,0,12,4,4,4,4,4,4,4,4,4,4,4,4,4,4,4,4,12,0,0,0,0,0,0,0,
0,0,0,0,0,0,12,4,4,4,4,4,4,4,4,4,4,4,4,4,4,4,4,12,0,0,0,0,0,0,0,
0,0,0,0,0,0,12,4,4,4,4,4,4,4,4,4,4,4,4,4,4,4,4,12,0,0,0,0,0,0,0,
0,0,0,0,0,0,12,4,4,4,4,4,4,4,4,4,4,4,4,4,4,4,4,12,0,0,0,0,0,0,0,
0,0,0,0,0,0,12,4,4,4,4,4,4,4,4,4,4,4,4,4,4,4,4,12,0,0,0,0,0,0,0,
0,0,0,0,0,0,12,12,12,12,12,12,12,12,12,12,12,12,12,12,12,12,12,12,0,0,0,0,0,0,0,
0,0,0,0,0,0,0,0,0,0,0,0,0,0,0,0,0,0,0,0,0,0,0,0,0,0,0,0,0,0,0,
0,0,0,0,0,0,0,0,0,0,0,0,0,0,0,0,0,0,0,0,0,0,0,0,0,0,0,0,0,0,0,
0,0,0,0,0,0,0,0,0,0,0,0,0,0,0,0,0,0,0,0,0,0,0,0,0,0,0,0,0,0,0,
0,0,0,0,0,0,0,0,0,0,0,0,0,0,0,0,0,0,0,0,0,0,0,0,0,0,0,0,0,0,0,
0,0,0,0,0,0,0,0,0,0,0,0,0,0,0,0,0,0,0,0,0,0,0,0,0,0,0,0,0,0,0,
0,0,0,0,0,0,0,0,0,0,0,0,0,0,0,0,0,0,0,0,0,0,0,0,0,0,0,0,0,0,0,
