9,9,9,9,9,9,9,8,8,8,8,8,8,8,7,7,7,7,6,6,5,5,4,4,4,4,4,4,4,4
9,9,9,9,9,9,9,8,8,8,8,8,8,8,7,7,7,7,6,6,5,5,4,4,4,4,4,4,4,4
9,9,9,9,9,9,9,8,8,8,8,8,8,8,7,7,7,7,6,6,5,5,4,4,4,4,4,4,4,4
9,9,9,9,9,9,9,8,8,8,8,8,8,8,7,7,7,7,6,6,5,5,4,4,4,4,4,4,4,4
9,9,9,9,9,9,9,8,8,8,8,8,8,8,7,7,7,7,6,6,5,5,4,4,4,4,4,4,4,4
9,9,9,9,9,9,9,8,8,8,8,8,8,8,7,7,7,7,6,6,5,5,4,4,4,4,4,4,4,4
9,9,9,9,9,9,9,8,8,8,8,8,8,8,7,7,7,7,6,6,5,5,4,4,4,4,4,4,4,4
9,9,9,9,9,9,9,8,8,8,8,8,8,8,7,7,7,7,6,6,5,5,4,4,4,4,4,4,4,4
9,9,9,9,9,9,9,8,8,8,8,8,8,8,7,7,7,7,6,6,5,5,4,4,4,4,4,4,4,4
8,8,8,8,8,8,8,8,8,8,8,8,8,8,7,7,7,7,6,6,5,5,4,4,4,4,4,4,4,4
8,8,8,8,8,8,8,8,8,8,8,8,8,8,7,7,7,7,6,6,5,5,4,4,4,4,4,4,4,4
8,8,8,8,8,8,8,8,8,8,8,8,8,8,7,7,7,7,6,6,5,5,4,4,4,4,4,4,4,4
8,8,8,8,8,8,8,8,8,8,8,8,8,8,7,7,7,7,6,6,5,5,4,4,4,4,4,4,4,4
8,8,8,8,8,8,8,8,8,8,8,8,8,8,7,7,7,7,6,6,5,5,4,4,4,4,4,4,4,4
8,8,8,8,8,8,8,8,8,8,8,8,8,8,7,7,7,7,6,6,5,5,4,4,4,4,4,4,4,4
8,8,8,8,8,8,8,8,8,8,8,8,8,8,7,7,7,7,6,6,5,5,4,4,4,4,4,4,4,4
8,8,8,8,8,8,8,8,8,8,8,8,8,8,7,7,7,7,6,6,5,5,4,4,4,4,4,4,4,4
7,7,7,7,7,7,7,7,7,7,7,7,7,7,7,7,7,7,6,6,5,5,4,4,4,4,4,4,4,4
7,7,7,7,7,7,7,7,7,7,7,7,7,7,7,7,7,7,6,6,5,5,4,4,4,4,4,4,4,4
7,7,7,7,7,7,7,7,7,7,7,7,7,7,7,7,7,7,6,6,5,5,4,4,4,4,4,4,4,4
7,7,7,7,7,7,7,7,7,7,7,7,7,7,7,7,7,7,6,6,5,5,4,4,4,4,4,4,4,4
6,6,6,6,6,6,6,6,6,6,6,6,6,6,6,6,6,6,6,6,5,5,4,4,4,4,4,4,4,4
6,6,6,6,6,6,6,6,6,6,6,6,6,6,6,6,6,6,6,6,5,5,4,4,4,4,4,4,4,4
5,5,5,5,5,5,5,5,5,5,5,5,5,5,5,5,5,5,5,5,5,5,4,4,4,4,4,4,4,4
5,5,5,5,5,5,5,5,5,5,5,5,5,5,5,5,5,5,5,5,5,5,4,4,4,4,4,4,4,4
4,4,4,4,4,4,4,4,4,4,4,4,4,4,4,4,4,4,4,4,4,4,4,4,4,4,4,4,4,4
4,4,4,4,4,4,4,4,4,4,4,4,4,4,4,4,4,4,4,4,4,4,4,4,4,4,4,4,4,4
4,4,4,4,4,4,4,4,4,4,4,4,4,4,4,4,4,4,4,4,4,4,4,4,4,4,4,4,4,4
4,4,4,4,4,4,4,4,4,4,4,4,4,4,4,4,4,4,4,4,4,4,4,4,4,4,4,4,4,4
4,4,4,4,4,4,4,4,4,4,4,4,4,4,4,4,4,4,4,4,4,4,4,4,4,4,4,4,4,4
