11,11,11,11,11,11,11,10,10,10,10,10,10,10,9,9,9,9,8,8,7,7,6,6,6,6,6,6,6,6
11,11,11,11,11,11,11,10,10,10,10,10,10,10,9,9,9,9,8,8,7,7,6,6,6,6,6,6,6,6
11,11,11,11,11,11,11,10,10,10,10,10,10,10,9,9,9,9,8,8,7,7,6,6,6,6,6,6,6,6
11,11,11,11,11,11,11,10,10,10,10,10,10,10,9,9,9,9,8,8,7,7,6,6,6,6,6,6,6,6
11,11,11,11,11,11,11,10,10,10,10,10,10,10,9,9,9,9,8,8,7,7,6,6,6,6,6,6,6,6
11,11,11,11,11,11,11,10,10,10,10,10,10,10,9,9,9,9,8,8,7,7,6,6,6,6,6,6,6,6
11,11,11,11,11,11,11,10,10,10,10,10,10,10,9,9,9,9,8,8,7,7,6,6,6,6,6,6,6,6
11,11,11,11,11,11,11,10,10,10,10,10,10,10,9,9,9,9,8,8,7,7,6,6,6,6,6,6,6,6
11,11,11,11,11,11,11,10,10,10,10,10,10,10,9,9,9,9,8,8,7,7,6,6,6,6,6,6,6,6
10,10,10,10,10,10,10,10,10,10,10,10,10,10,9,9,9,9,8,8,7,7,6,6,6,6,6,6,6,6
10,10,10,10,10,10,10,10,10,10,10,10,10,10,9,9,9,9,8,8,7,7,6,6,6,6,6,6,6,6
10,10,10,10,10,10,10,10,10,10,10,10,10,10,9,9,9,9,8,8,7,7,6,6,6,6,6,6,6,6
10,10,10,10,10,10,10,10,10,10,10,10,10,10,9,9,9,9,8,8,7,7,6,6,6,6,6,6,6,6
10,10,10,10,10,10,10,10,10,10,10,10,10,10,9,9,9,9,8,8,7,7,6,6,6,6,6,6,6,6
10,10,10,10,10,10,10,10,10,10,10,10,10,10,9,9,9,9,8,8,7,7,6,6,6,6,6,6,6,6
10,10,10,10,10,10,10,10,10,10,10,10,10,10,9,9,9,9,8,8,7,7,6,6,6,6,6,6,6,6
10,10,10,10,10,10,10,10,10,10,10,10,10,10,9,9,9,9,8,8,7,7,6,6,6,6,6,6,6,6
9,9,9,9,9,9,9,9,9,9,9,9,9,9,9,9,9,9,8,8,7,7,6,6,6,6,6,6,6,6
9,9,9,9,9,9,9,9,9,9,9,9,9,9,9,9,9,9,8,8,7,7,6,6,6,6,6,6,6,6
9,9,9,9,9,9,9,9,9,9,9,9,9,9,9,9,9,9,8,8,7,7,6,6,6,6,6,6,6,6
9,9,9,9,9,9,9,9,9,9,9,9,9,9,9,9,9,9,8,8,7,7,6,6,6,6,6,6,6,6
8,8,8,8,8,8,8,8,8,8,8,8,8,8,8,8,8,8,8,8,7,7,6,6,6,6,6,6,6,6
8,8,8,8,8,8,8,8,8,8,8,8,8,8,8,8,8,8,8,8,7,7,6,6,6,6,6,6,6,6
7,7,7,7,7,7,7,7,7,7,7,7,7,7,7,7,7,7,7,7,7,7,6,6,6,6,6,6,6,6
7,7,7,7,7,7,7,7,7,7,7,7,7,7,7,7,7,7,7,7,7,7,6,6,6,6,6,6,6,6
6,6,6,6,6,6,6,6,6,6,6,6,6,6,6,6,6,6,6,6,6,6,6,6,6,6,6,6,6,6
6,6,6,6,6,6,6,6,6,6,6,6,6,6,6,6,6,6,6,6,6,6,6,6,6,6,6,6,6,6
6,6,6,6,6,6,6,6,6,6,6,6,6,6,6,6,6,6,6,6,6,6,6,6,6,6,6,6,6,6
6,6,6,6,6,6,6,6,6,6,6,6,6,6,6,6,6,6,6,6,6,6,6,6,6,6,6,6,6,6
6,6,6,6,6,6,6,6,6,6,6,6,6,6,6,6,6,6,6,6,6,6,6,6,6,6,6,6,6,6
